NO ./sprites/WN.xpm
SO ./sprites/WS.xpm
WE ./sprites/Ww.xpm
EA ./sprites/WE.xpm

F 40,120,220
C 50,50,20

111111111111111111111111111
100000000000000000000000001
100000000000010000000000001
100000000000000000000000001
1000000010000W0000100000001
100000000000000000000000001
100000000000000100000000001
100000000000000000000000011
100000000000000000000000001
100000000000000000000000001
110000000000000000000000001
100000000000000000000000011
111111111111111111111111111
