1111111
1000001
111N001
1000001
1111111
