111111111
100000001
100000001
100000001
1000S0001
100001001
100000001
100000001
111111111
