1111111111111
1000000001111
111W101000001
1000000010001
1001001001001
1101000000001
1111111111111
