NO ./sprites/WN.xpm
SO ./sprites/WS.xpm
WE ./sprites/WW.xpm
EA     ./sprites/WE.xpm


F 20,20,20
C 220,20,20

111111111
100010001
100101001
100000001
1000N0001
100000001
100000001
100000001
111111111
