111111111
100010001
100101001
100000001
1000N0001
100001001
100000001
100000001
111111111
