NO ./sprites/W1.xpm
SO ./sprites/W2.xpm
WE ./sprites/W3.xpm
EA ./sprites/W4.xpm


F 20,20,20
C 220,20,20



1111111111111j1111111111111
100000000000000000000000001
100000001000111111000001111
100000001000000000000000001
100010001111111111100001111
111010000000000000000100001
100010000000001100000111101
111111000010000000000100011
100000000000010000000111111
100000100000111000000000001
111111000000000000000111111
1000000000000N0000000000011
111111111111111111111111111
