NO ./sprites/W1.xpm
SO ./sprites/W2.xpm
WE ./sprites/W3.xpm
EA     ./sprites/W4.xpm

F 220,100,0
C 225,30,0

111111111111111
110000000000111
100000N00000001
111000000000011
111000000000111
111111111111111
