NO ./sprites/WN.xpm
SO ./sprites/WS.xpm
WE ./sprites/WW.xpm
EA     ./sprites/WE.xpm


F 20,20,20
C 220,20,20

 111 
 101
 111
 1    1       
111111111
100010001
111101001
100000001
100000001
10W000001
100000001
100000001
111111111
