NO ./sprites/W1.xpm
SO ./sprites/W2.xpm
WE ./sprites/W3.xpm
EA ./sprites/W4.xpm

F 255,255,255
C 135,206,250

1111111111111111111111111
1000000000110000000000001
1011000001110000001000001
1001000000000000000000001
1111111110110000011100001
1000000000110000011101111111
1111011111111101110000000011
1111011111111101110101001111
1100000011010101110000001
1000000000000000110000001
1000000000N00000110101001
1100000111010101111101101
1111011111110101110111101
1111111111111111111111111
